11111111111111111111
10000000C000000000001
10000000000001000001
10000000000000000001
10010000000C00000001
1000000C000000000001
10000000000000110001
100P0000000000011101
100000000000000111E1
11111111111111111111
