11111111111111111111111111111111
1111111111111100P011111111111111
11111111111000000000011111111111
11111111000000000000000011111111
111111000000000C0000000000111111
11111000000000000000000000011111
11110000000000000000100000001111
11110000000000000000000000001111
1110001000000CC00000000000000111
11100000000000000000000000000111
11100001000000C00000000000000111
110000000000000000000C0000000011
11000000000000001000000000000011
11000000000010000000000000000011
1000000C000000000000000000000001
100000000000000C0000000000000001
10000000000000000000000000000001
10000000000000000000000000C00001
1100000000C000000011110000000011
1100000000000000001C010000000011
11000000000011111C10000000000011
11100000000011111010000000000111
11100000000011C00010C00000000111
11100100000011111110001000000111
11110000000011111110000000001111
11110000000001000000000000001111
11111000000000000000000000011111
11111100011111111111111111111111
1111111100000000E000000011111111
11111111111000000000011111111111
11111111111111000011111111111111
11111111111111111111111111111111
