11111111111111111111111111111111
11111111111111EPPE11111111111111
11111111111PPPPPPPPPP11111111111
11111111PPPPPPPPPPPPPPPP11111111
111111PPPPPPPPPCPPPPPPPPPP111111
11111PPPPPPPEPPPPPPPPPPPPPP11111
1111PPPPPPPPPPPP111PPPPPPPPP1111
1111PPPPPPPPPPPPPPPPPPPEPPPP1111
111PPP1C1PPPPCCPPPPPPPPPPPPPP111
111PPP111PPPPPPPPPPPPPPPPPPPP111
111PPPPPPPPPPPPCPPPPPPPPPPPPP111
11PPPPPPPPPPPPPPPPPPPCPPPPPPPP11
11EPPPPPPPPPPPPP1PPPPPPPPPPPPP11
11PPPPPPPPPP1PPPPPPPPPPPPPPPPP11
1EPPPPPCPPPPPPPPPPEPPPPPEPPPPPP1
1PPPPPPPPPPPPPPCPPPPPPPPPPPPPPP1
1PPPPPPPPPPPPPPPPPPPPPPPPPPPPPP1
1PPPPPPPPPPPPEPPPPPPPPPPPPCPPPP1
11PPPPPPPPCPPPPPPP1111PPPPPPPP11
11PPPPPPPPPPPPPPPP1CP1PPPPPPPP11
11PPPPPPPPPP11111P1PPPPPPPPPPP11
111PPPPPPPPP1CCC1P1PPPPPPPPPP111
111PPPPPPPPP1CCCCC1PCPPPPPPPP111
111PP1PPPPPP1CCCCC1PPP1PPPPPP111
1111PPPPPPPP1111111PPPPPPPPP1111
1111PPPPPPPPP1PPPPPPPPPPPPPP1111
11111PPPPPPPPPPPPPPPPPPPPPE11111
111111PPP11111111111111111111111
11111111PPPPPPPPPPPPPPPP11111111
11111111111PPPPPPPPPP11111111111
11111111111111EPPE11111111111111
11111111111111111111111111111111
