11111111111111111111111111111111
11111111111111111111111111111111
11111111111PPPPPPPPP111111111111
11111111110011100000P11111111111
11111111100111000000001111111111
111111111P111100E000001111111111
11111111001100000000000111111111
1111111001100000C000000011111111
11111110111000000000000011111111
1111111011100000000000C011111111
11111110111000000000000011111111
111111101110C0000000000011111111
11111110111000000000000011111111
11111110110000000000000011111111
11111110110000000000000011111111
111111101100000000000E0011111111
1111111011C000CC0000000001111111
111111PP11000000000000CPCP111111
111110101100000000000001C0111111
11111010110E0000000000C1C0111111
111110101100000000000001C0111111
1111110011000011P110000100111111
1111110011000001110C000001111111
1111111011C000001000000011111111
111111101100000P1000000011111111
111111101100000P1000000011111111
1111111011000C011100000011111111
11111110110000110110C00011111111
111111100000PPPPPPPP000011111111
111111101100000011C0C0C011111111
1111111PEEEEEEPP1EEEEEEE11111111
11111111111111111111111111111111
