111111111111111111111111111111
11PC00000000000000000000000011
111111111111111111111111111011
1100000000000000000C1000001011
110111111111111111111011101011
1101P00000000000000C1000101011
110101111111111110111110101011
110101C000000000001C0010101011
110101111111111110111010101011
1101C0010000000000001010101011
110111010111111111101010101011
1101C10101P0000000101010101011
110101010101111110101010101011
110101010101ECCE10101010101011
110101010101CCCC001010101P1011
110101010101ECCE11101010101011
110101010101111111101010101011
110101010100000000001010101011
110101010111111111111010101011
110101010000000000000010101011
110101011111111111111110101011
11010100000000000000000C101011
110101111111111111111111101011
110100000000000000000000001011
110111111111110111111111111011
11C000000000P00000000000000P11
111111111111111111111111111111
111111111111111111111111111111
111111111111111111111111111111
111111111111111111111111111111
