11111111111111111111
1P0000PE000000000001
1000000P00000PC000E1
1E000000000000000001
11111111E11111111101
1CE0000000000000E001
10111111011111111111
10000000000000000001
11111111011111111101
100C00000000C00000C1
10111111011111111111
10000011011E00E00E11
11111100000111101111
10000000000000000001
10C00000C0000000C001
100000000C0000000001
10000000000000000001
100C000000000000CCC1
100000000E00000CCCC1
11111111111111111111
