11111111111111111111
1PPPPPPEPPPPPPPPPPP1
1PPPPPPPPPPPPPCPPPE1
1EPPPPPPPPPPPPPPPPP1
11111111E11111111101
1CEPPPPPPPPPPPPPEPP1
1P111111P11111111111
1PPPPPPPPPPPPPPPPPP1
11111111P111111111P1
1PPCPPPPPPPPCPPPPPC1
1P111111P11111111111
1PPPPP11P11EPPEPPE11
111111PPPPP1111P1111
1PPPPPPPPPPPPPPPPPP1
1PCPPPPPCPPPPPPPCPP1
1PPPPPPPPCPPPPPPPPP1
1PPPPPPPPPPPPPPPPPP1
1PPCPPPPPPPPPPPPCCC1
1PPPPPPPPEPPPPPCCCC1
11111111111111111111
