11111111111111111111
1P000000000000000001
10000000000000000001
10000000000000000001
11111111011111111101
10000000000000000001
10111111011111111111
10000000000000000001
11111111011111111101
10000000000000000001
10111111011111111111
10000011011000000011
11111100000111111111
100000000000000000E1
1000000000C000000001
10000000000000000001
10000000000000000001
10000000000000000001
100000000000000000E1
11111111111111111111
