11
1111
1111
1111
1111
1111
1111
1111
1111
1111
1111
11
