11111111111111111111
1P000000C00000000E01
100000000P0001000001
1E000000000000000001
10010000000C00000001
10000P0C000000000001
10000000000000110001
100P000000E000011101
100000000000000111E1
11111111111111111111
