11111111111111111111111111111111111111111111111111111111
1P000000000000000000000000000000000000000000000000000001
10000000000000000000C00000000000000000000000000000110101
11111111111111111111111111111111111111111111111111110101
11111111111111111111111111111111111111111111111111110101
111110000000000000000C0000000000000000000000000000000001
11111000011111111111111111110111111111111111111111111111
11111111000000000000111111110111110111111111111111111111
11111111111111111110111111110111111011111111111111111111
11111111111111111110111111110111111111111111111111111111
11110000000000000000000000000000000000000000000011111111
11111111111111111110111111000000000000000000000111111111
11111111111111111110111011110111111111111111111111111111
111111111111111C1110111111110111111111111111111111111111
11111111111111111110111111110111111111111111111111111111
11111111111111111110111111110111111111111101111111111111
11111111111111111110110111110111111111100000000000001111
11111111111111111110000000000000000000001111111111111111
11111111111111111111111111110111111111111111111111111111
11111111000000000000000000000000000000000000000000001111
11111111111111111111111111110111111111111111111111111111
1111000000000000C000000000000000000000000000111111111111
11111111111111111111111111110111111111111111111111111111
111111111111111C1111111111110111111111111111111111111111
1111111111111111111111111111000000000000000000000000E111
11111111111111111111111111111111111111111111111111111111
